01023---011233--

01023---011233--

23201---30120---

23201---20301---

2211212-3300330-

01023---011233--

01023---011233--

23201---30120---

23201---20301---