GKILN---GKILPN--

GKILN---GKILPN--

LPNIK---LINLK---

LPNIK---LINIG---

EEDDEDE-EEDDEED-

GKILN---GKILPN--

GKILN---GKILPN--

LPNIK---LINLK---

LPNIK---LINIG---